# # # # # # # # # # # # # # # #
# . . . . . . . . . . . . . . #
# . # # # G # . # # # # # # . #
# . . . # . # . # . . . . . . #
# # # . # . # # # # # G # . . #
# . . . # . . . # . . . # . E #
# # # . # . # . . . # . # # # #
# . . . . . . . . # . . . . S #
# # # # # # # # # # # # # # # #