# # # # # # # # # # # # # # # # #
# S . . . . # . . . . . . . . . #
# . # # # . # . # # # # # # # . #
# . . . # . # . # . . . . . # . #
# # # . # . # # # G # . # . # # #
# . . . # . . . # . . . # . . . #
# # # # # G # . # . # . # # # . #
# . . . . . . . . . # . . . . . #
# # # # # # # # # # # # # # # E #