# # # # # # # # # # # # # # # #
# S . . . . # . . . . . . . . #
# # # # # . # . # # # # # # . #
# . . . # . # . # . . . # . . #
# # # . . . # . # . # . # . . #
# . . . # . G . # . # . # . . #
# # # # # . # . # . # . # # . #
# . . . . . . . . . # . G . . #
# # # # # # # # # # # # # # E #