# # # # # # # # # # # # # # # #
# . . . . . # . . . . . . G . #
# # # . # . # . # # # # # # # #
# . . . # . # . # . . . . . # #
# # # . # . # # # G # . # . # #
# . . . # . . . # . . . # . . #
# . # # # . # . # . # . # # # #
# S . . G . . . . . # . . . E #
# # # # # # # # # # # # # # # #