# # # # # # # # # # # # # # # #
# . . . . . # G . . . . . . E #
# # # # # . # . # # # . # # # #
# . . . # . . . # . . . . . # #
# # # . # . # # # . # . # . # #
# . . . . . G . # . . . # . . #
# . # # # . # . # . # . # # # #
# S # . . . . . . . # . . . . #
# # # # # # # # # # # # # # # #